1111111111111
10E00P0010001
1111111110001
10000C0010001
1111111111111