1111111
101C1P1
1110111
1E00001
1110111
1000101
1111111