1111111111
1P00000001
111C111111
1110000001
10C11100E1
1001110111
1000C00001
1111111111